NO ./texture/north_texture.xpm
SO ./texture/south_texture.xpm
WE ./texture/west_texture.xpm
EA ./texture/east_texture.xpm

C 26,161,199
F 107,75,85


11111111111
10000000001
10000000001
11000000001
01000000001
01000000001
01000N00001
11000000001
10000000001
10000000001
11111111111
