NO ./texture/north_texture.xpm
SO ./texture/south_texture.xpm
WE ./texture/west_texture.xpm
EA ./texture/east_texture.xpm

C 26,161,199
F 107,75,85


E1111111111
10000000001
10000000001
10000000001
10000000001
10000000001
10000000001
10000000001
10000000001
10000000001
11111111111
