NO ./texture/north_texture
SO ./texture/south_texture
WE ./texture/west_texture
EA ./texture/east_texture

F 220,100,0
C 225,30,0

1111111        111111
10100011111    100001
10101000001    101001
1N101101011111101101
10101101000000000101
10000101001111110101
11110101101    100101
   10101001    101101
   10101011    101101
   10101001    100101
   10101101111111101
   10100100000000001
   10101111111111111
   10100000001
   10111111101
   10000000001
   11111111111