NO ./texture/north_texture.xpm
SO ./texture/south_texture.xpm
WE ./texture/west_texture.xpm
EA ./texture/east_texture.xpm

F 16,16,16
C 0,0,0

1111111
1000001
100N001
1000001
1111111
