NO ./texture/north_texture.xpm
SO ./texture/south_texture.xpm
WE ./texture/west_texture.xpm
EA ./texture/east_texture.xpm

F 0,170,0
C 50,100,255

1111111
1000001
100N001
1000001
1111111
